1111111111111111
1E000000C0000C01
1000C00000C10001
10101010C0100001
10000C1C100000C1
1111111111111111