1111111111111111
1E00000000000001
1000000000010001
1010101000100001
1P00001010000001
1111111111111111