11111111111111111111111111111111111111111111111111111111111
11010101010101011010101C10101010101010101010101010101010101
1000C000000010000C0000000000C00000000000100000000000C000001
11000000000010001000000000010000000001000000000000001001001
100000000000C1000000000100000000C10000000000000000000000001
10000000000000000000001E10000000000000000000000000000000001
10101010101010101010101C10101010101010101010101010101010101
10000000000000000C0000000000C00000000000100000000000C000001
10000000000100001000000000010000000001000000000000001001001
100000000000C10000000001P0000000C10000000000000000000000001
11111111111111111111111111111111111111111111111111111111111